"a" = (/turf/simulated/floor/holofloor/space,/area/space)
"b" = (/turf/unsimulated/wall,/area/space)
"c" = (/turf/simulated/floor/holofloor/tiled,/area/space)
"d" = (/turf/space,/area/space)

(1,1,1) = {"
aaaaaaaaaaaaaaaaaaaaaaaaaaaaaaaaaaaaaaaaaaaaaaaaaaaaaaaaaaaaaaaaaaaaaaaaaaaaaaaaaaaaaaaaaaaaaaaaaaaaaaaaaaaaaaaaaaaaaaaaaaaaaaaaaaaaaaaaaaaa
acccccccadddddddddddddddddddddddaaaaaaaaaaaaaaaaaaaaaaaaaaaaaaaaaaaaaaaaaaaaaaaaaaaaaaaaaaaaaaaaaaaaaaaaaaaaaaaaaaaaaaaaaaaaaaaaaaaaaaaaaaaa
acccccccadddddddddddddddddddddddaaaaaaaaaaaaaaaaaaaaaaaaaaaaaaaaaaaaaaaaaaaaaaaaaaaaaaaaaaaaaaaaaaaaaaaaaaaaaaaaaaaaaaaaaaaaaaaaaaaaaaaaaaaa
acccccccadddddddddddddddddddddddaaaaaaaaaaaaaaaaaaaaaaaaaaaaaaaaaaaaaaaaaaaaaaaaaaaaaaaaaaaaaaaaaaaaaaaaaaaaaaaaaaaaaaaaaaaaaaaaaaaaaaaaaaaa
acccccccadddddddddddddddddddddddaaaaaaaaaaaaaaaaaaaaaaaaaaaaaaaaaaaaaaaaaaaaaaaaaaaaaaaaaaaaaaaaaaaaaaaaaaaaaaaaaaaaaaaaaaaaaaaaaaaaaaaaaaaa
acccccccadddddddddddddddddddddddaaaaaaaaaaaaaaaaaaaaaaaaaaaaaaaaaaaaaaaaaaaaaaaaaaaaaaaaaaaaaaaaaaaaaaaaaaaaaaaaaaaaaaaaaaaaaaaaaaaaaaaaaaaa
acccccccadddddddddddddddddddddddaaaaaaaaaaaaaaaaaaaaaaaaaaaaaaaaaaaaaaaaaaaaaaaaaaaaaaaaaaaaaaaaaaaaaaaaaaaaaaaaaaaaaaaaaaaaaaaaaaaaaaaaaaaa
acccccccadddddddddddddddddddddddaaaaaaaaaaaaaaaaaaaaaaaaaaaaaaaaaaaaaaaaaaaaaaaaaaaaaaaaaaaaaaaaaaaaaaaaaaaaaaaaaaaaaaaaaaaaaaaaaaaaaaaaaaaa
aaaaaaaaaaaaaaaaaaaaaaaaaaaaaaaaaaaaaaaaaaaaaaaaaaaaaaaaaaaaaaaaaaaaaaaaaaaaaaaaaaaaaaaaaaaaaaaaaaaaaaaaaaaaaaaaaaaaaaaaaaaaaaaaaaaaaaaaaaaa
adddddddddddddddddddddddddddddddaaaaaaaaaaaaaaaaaaaaaaaaaaaaaaaaaaaaaaaaaaaaaaaaaaaaaaaaaaaaaaaaaaaaaaaaaaaaaaaaaaaaaaaaaaaaaaaaaaaaaaaaaaaa
adddddddddddddddddddddddddddddddaaaaaaaaaaaaaaaaaaaaaaaaaaaaaaaaaaaaaaaaaaaaaaaaaaaaaaaaaaaaaaaaaaaaaaaaaaaaaaaaaaaaaaaaaaaaaaaaaaaaaaaaaaaa
adddddddddddddddddddddddddddddddaaaaaaaaaaaaaaaaaaaaaaaaaaaaaaaaaaaaaaaaaaaaaaaaaaaaaaaaaaaaaaaaaaaaaaaaaaaaaaaaaaaaaaaaaaaaaaaaaaaaaaaaaaaa
adddddddddddddddddddddddddddddddaaaaaaaaaaaaaaaaaaaaaaaaaaaaaaaaaaaaaaaaaaaaaaaaaaaaaaaaaaaaaaaaaaaaaaaaaaaaaaaaaaaaaaaaaaaaaaaaaaaaaaaaaaaa
adddddddddddddddddddddddddddddddaaaaaaaaaaaaaaaaaaaaaaaaaaaaaaaaaaaaaaaaaaaaaaaaaaaaaaaaaaaaaaaaaaaaaaaaaaaaaaaaaaaaaaaaaaaaaaaaaaaaaaaaaaaa
adddddddddddddddddddddddddddddddaaaaaaaaaaaaaaaaaaaaaaaaaaaaaaaaaaaaaaaaaaaaaaaaaaaaaaaaaaaaaaaaaaaaaaaaaaaaaaaaaaaaaaaaaaaaaaaaaaaaaaaaaaaa
adddddddddddddddddddddddddddddddaaaaaaaaaaaaaaaaaaaaaaaaaaaaaaaaaaaaaaaaaaaaaaaaaaaaaaaaaaaaaaaaaaaaaaaaaaaaaaaaaaaaaaaaaaaaaaaaaaaaaaaaaaaa
aaaaaaaaaaaaaaaaaaaaaaaaaaaaaaaaaaaaaaaaaaaaaaaaaaaaaaaaaaaaaaaaaaaaaaaaaaaaaaaaaaaaaaaaaaaaaaaaaaaaaaaaaaaaaaaaaaaaaaaaaaaaaaaaaaaaaaaaaaaa
aaaaaaaaaaaaaaaaaaaaaaaaaaaaaaaaaaaaaaaaaaaaaaaaaaaaaaaaaaaaaaaaaaaaaaaaaaaaaaaaaaaaaaaaaaaaaaaaaaaaaaaaaaaaaaaaaaaaaaaaaaaaaaaaaaaaaaaaaaaa
aaaaaaaaaaaaaaaaaaaaaaaaaaaaaaaaaaaaaaaaaaaaaaaaaaaaaaaaaaaaaaaaaaaaaaaaaaaaaaaaaaaaaaaaaaaaaaaaaaaaaaaaaaaaaaaaaaaaaaaaaaaaaaaaaaaaaaaaaaaa
aaaaaaaaaaaaaaaaaaaaaaaaaaaaaaaaaaaaaaaaaaaaaaaaaaaaaaaaaaaaaaaaaaaaaaaaaaaaaaaaaaaaaaaaaaaaaaaaaaaaaaaaaaaaaaaaaaaaaaaaaaaaaaaaaaaaaaaaaaaa
aaaaaaaaaaaaaaaaaaaaaaaaaaaaaaaaaaaaaaaaaaaaaaaaaaaaaaaaaaaaaaaaaaaaaaaaaaaaaaaaaaaaaaaaaaaaaaaaaaaaaaaaaaaaaaaaaaaaaaaaaaaaaaaaaaaaaaaaaaaa
aaaaaaaaaaaaaaaaaaaaaaaaaaaaaaaaaaaaaaaaaaaaaaaaaaaaaaaaaaaaaaaaaaaaaaaaaaaaaaaaaaaaaaaaaaaaaaaaaaaaaaaaaaaaaaaaaaaaaaaaaaaaaaaaaaaaaaaaaaaa
aaaaaaaaaaaaaaaaaaaaaaaaaaaaaaaaaaaaaaaaaaaaaaaaaaaaaaaaaaaaaaaaaaaaaaaaaaaaaaaaaaaaaaaaaaaaaaaaaaaaaaaaaaaaaaaaaaaaaaaaaaaaaaaaaaaaaaaaaaaa
aaaaaaaaaaaaaaaaaaaaaaaaaaaaaaaaaaaaaaaaaaaaaaaaaaaaaaaaaaaaaaaaaaaaaaaaaaaaaaaaaaaaaaaaaaaaaaaaaaaaaaaaaaaaaaaaaaaaaaaaaaaaaaaaaaaaaaaaaaaa
aaaaaaaaaaaaaaaaaaaaaaaaaaaaaaaaaaaaaaaaaaaaaaaaaaaaaaaaaaaaaaaaaaaaaaaaaaaaaaaaaaaaaaaaaaaaaaaaaaaaaaaaaaaaaaaaaaaaaaaaaaaaaaaaaaaaaaaaaaaa
aaaaaaaaaaaaaaaaaaaaaaaaaaaaaaaaaaaaaaaaaaaaaaaaaaaaaaaaaaaaaaaaaaaaaaaaaaaaaaaaaaaaaaaaaaaaaaaaaaaaaaaaaaaaaaaaaaaaaaaaaaaaaaaaaaaaaaaaaaaa
aaaaaaaaaaaaaaaaaaaaaaaaaaaaaaaaaaaaaaaaaaaaaaaaaaaaaaaaaaaaaaaaaaaaaaaaaaaaaaaaaaaaaaaaaaaaaaaaaaaaaaaaaaaaaaaaaaaaaaaaaaaaaaaaaaaaaaaaaaaa
aaaaaaaaaaaaaaaaaaaaaaaaaaaaaaaaaaaaaaaaaaaaaaaaaaaaaaaaaaaaaaaaaaaaaaaaaaaaaaaaaaaaaaaaaaaaaaaaaaaaaaaaaaaaaaaaaaaaaaaaaaaaaaaaaaaaaaaaaaaa
aaaaaaaaaaaaaaaaaaaaaaaaaaaaaaaaaaaaaaaaaaaaaaaaaaaaaaaaaaaaaaaaaaaaaaaaaaaaaaaaaaaaaaaaaaaaaaaaaaaaaaaaaaaaaaaaaaaaaaaaaaaaaaaaaaaaaaaaaaaa
aaaaaaaaaaaaaaaaaaaaaaaaaaaaaaaaaaaaaaaaaaaaaaaaaaaaaaaaaaaaaaaaaaaaaaaaaaaaaaaaaaaaaaaaaaaaaaaaaaaaaaaaaaaaaaaaaaaaaaaaaaaaaaaaaaaaaaaaaaaa
aaaaaaaaaaaaaaaaaaaaaaaaaaaaaaaaaaaaaaaaaaaaaaaaaaaaaaaaaaaaaaaaaaaaaaaaaaaaaaaaaaaaaaaaaaaaaaaaaaaaaaaaaaaaaaaaaaaaaaaaaaaaaaaaaaaaaaaaaaaa
aaaaaaaaaaaaaaaaaaaaaaaaaaaaaaaaaaaaaaaaaaaaaaaaaaaaaaaaaaaaaaaaaaaaaaaaaaaaaaaaaaaaaaaaaaaaaaaaaaaaaaaaaaaaaaaaaaaaaaaaaaaaaaaaaaaaaaaaaaaa
aaaaaaaaaaaaaaaaaaaaaaaaaaaaaaaaaaaaaaaaaaaaaaaaaaaaaaaaaaaaaaaaaaaaaaaaaaaaaaaaaaaaaaaaaaaaaaaaaaaaaaaaaaaaaaaaaaaaaaaaaaaaaaaaaaaaaaaaaaaa
aaaaaaaaaaaaaaaaaaaaaaaaaaaaaaaaaaaaaaaaaaaaaaaaaaaaaaaaaaaaaaaaaaaaaaaaaaaaaaaaaaaaaaaaaaaaaaaaaaaaaaaaaaaaaaaaaaaaaaaaaaaaaaaaaaaaaaaaaaaa
aaaaaaaaaaaaaaaaaaaaaaaaaaaaaaaaaaaaaaaaaaaaaaaaaaaaaaaaaaaaaaaaaaaaaaaaaaaaaaaaaaaaaaaaaaaaaaaaaaaaaaaaaaaaaaaaaaaaaaaaaaaaaaaaaaaaaaaaaaaa
aaaaaaaaaaaaaaaaaaaaaaaaaaaaaaaaaaaaaaaaaaaaaaaaaaaaaaaaaaaaaaaaaaaaaaaaaaaaaaaaaaaaaaaaaaaaaaaaaaaaaaaaaaaaaaaaaaaaaaaaaaaaaaaaaaaaaaaaaaaa
aaaaaaaaaaaaaaaaaaaaaaaaaaaaaaaaaaaaaaaaaaaaaaaaaaaaaaaaaaaaaaaaaaaaaaaaaaaaaaaaaaaaaaaaaaaaaaaaaaaaaaaaaaaaaaaaaaaaaaaaaaaaaaaaaaaaaaaaaaaa
aaaaaaaaaaaaaaaaaaaaaaaaaaaaaaaaaaaaaaaaaaaaaaaaaaaaaaaaaaaaaaaaaaaaaaaaaaaaaaaaaaaaaaaaaaaaaaaaaaaaaaaaaaaaaaaaaaaaaaaaaaaaaaaaaaaaaaaaaaaa
aaaaaaaaaaaaaaaaaaaaaaaaaaaaaaaaaaaaaaaaaaaaaaaaaaaaaaaaaaaaaaaaaaaaaaaaaaaaaaaaaaaaaaaaaaaaaaaaaaaaaaaaaaaaaaaaaaaaaaaaaaaaaaaaaaaaaaaaaaaa
aaaaaaaaaaaaaaaaaaaaaaaaaaaaaaaaaaaaaaaaaaaaaaaaaaaaaaaaaaaaaaaaaaaaaaaaaaaaaaaaaaaaaaaaaaaaaaaaaaaaaaaaaaaaaaaaaaaaaaaaaaaaaaaaaaaaaaaaaaaa
aaaaaaaaaaaaaaaaaaaaaaaaaaaaaaaaaaaaaaaaaaaaaaaaaaaaaaaaaaaaaaaaaaaaaaaaaaaaaaaaaaaaaaaaaaaaaaaaaaaaaaaaaaaaaaaaaaaaaaaaaaaaaaaaaaaaaaaaaaaa
aaaaaaaaaaaaaaaaaaaaaaaaaaaaaaaaaaaaaaaaaaaaaaaaaaaaaaaaaaaaaaaaaaaaaaaaaaaaaaaaaaaaaaaaaaaaaaaaaaaaaaaaaaaaaaaaaaaaaaaaaaaaaaaaaaaaaaaaaaaa
aaaaaaaaaaaaaaaaaaaaaaaaaaaaaaaaaaaaaaaaaaaaaaaaaaaaaaaaaaaaaaaaaaaaaaaaaaaaaaaaaaaaaaaaaaaaaaaaaaaaaaaaaaaaaaaaaaaaaaaaaaaaaaaaaaaaaaaaaaaa
aaaaaaaaaaaaaaaaaaaaaaaaaaaaaaaaaaaaaaaaaaaaaaaaaaaaaaaaaaaaaaaaaaaaaaaaaaaaaaaaaaaaaaaaaaaaaaaaaaaaaaaaaaaaaaaaaaaaaaaaaaaaaaaaaaaaaaaaaaaa
aaaaaaaaaaaaaaaaaaaaaaaaaaaaaaaaaaaaaaaaaaaaaaaaaaaaaaaaaaaaaaaaaaaaaaaaaaaaaaaaaaaaaaaaaaaaaaaaaaaaaaaaaaaaaaaaaaaaaaaaaaaaaaaaaaaaaaaaaaaa
aaaaaaaaaaaaaaaaaaaaaaaaaaaaaaaaaaaaaaaaaaaaaaaaaaaaaaaaaaaaaaaaaaaaaaaaaaaaaaaaaaaaaaaaaaaaaaaaaaaaaaaaaaaaaaaaaaaaaaaaaaaaaaaaaaaaaaaaaaaa
aaaaaaaaaaaaaaaaaaaaaaaaaaaaaaaaaaaaaaaaaaaaaaaaaaaaaaaaaaaaaaaaaaaaaaaaaaaaaaaaaaaaaaaaaaaaaaaaaaaaaaaaaaaaaaaaaaaaaaaaaaaaaaaaaaaaaaaaaaaa
aaaaaaaaaaaaaaaaaaaaaaaaaaaaaaaaaaaaaaaaaaaaaaaaaaaaaaaaaaaaaaaaaaaaaaaaaaaaaaaaaaaaaaaaaaaaaaaaaaaaaaaaaaaaaaaaaaaaaaaaaaaaaaaaaaaaaaaaaaaa
aaaaaaaaaaaaaaaaaaaaaaaaaaaaaaaaaaaaaaaaaaaaaaaaaaaaaaaaaaaaaaaaaaaaaaaaaaaaaaaaaaaaaaaaaaaaaaaaaaaaaaaaaaaaaaaaaaaaaaaaaaaaaaaaaaaaaaaaaaaa
aaaaaaaaaaaaaaaaaaaaaaaaaaaaaaaaaaaaaaaaaaaaaaaaaaaaaaaaaaaaaaaaaaaaaaaaaaaaaaaaaaaaaaaaaaaaaaaaaaaaaaaaaaaaaaaaaaaaaaaaaaaaaaaaaaaaaaaaaaaa
aaaaaaaaaaaaaaaaaaaaaaaaaaaaaaaaaaaaaaaaaaaaaaaaaaaaaaaaaaaaaaaaaaaaaaaaaaaaaaaaaaaaaaaaaaaaaaaaaaaaaaaaaaaaaaaaaaaaaaaaaaaaaaaaaaaaaaaaaaaa
aaaaaaaaaaaaaaaaaaaaaaaaaaaaaaaaaaaaaaaaaaaaaaaaaaaaaaaaaaaaaaaaaaaaaaaaaaaaaaaaaaaaaaaaaaaaaaaaaaaaaaaaaaaaaaaaaaaaaaaaaaaaaaaaaaaaaaaaaaaa
aaaaaaaaaaaaaaaaaaaaaaaaaaaaaaaaaaaaaaaaaaaaaaaaaaaaaaaaaaaaaaaaaaaaaaaaaaaaaaaaaaaaaaaaaaaaaaaaaaaaaaaaaaaaaaaaaaaaaaaaaaaaaaaaaaaaaaaaaaaa
aaaaaaaaaaaaaaaaaaaaaaaaaaaaaaaaaaaaaaaaaaaaaaaaaaaaaaaaaaaaaaaaaaaaaaaaaaaaaaaaaaaaaaaaaaaaaaaaaaaaaaaaaaaaaaaaaaaaaaaaaaaaaaaaaaaaaaaaaaaa
aaaaaaaaaaaaaaaaaaaaaaaaaaaaaaaaaaaaaaaaaaaaaaaaaaaaaaaaaaaaaaaaaaaaaaaaaaaaaaaaaaaaaaaaaaaaaaaaaaaaaaaaaaaaaaaaaaaaaaaaaaaaaaaaaaaaaaaaaaaa
aaaaaaaaaaaaaaaaaaaaaaaaaaaaaaaaaaaaaaaaaaaaaaaaaaaaaaaaaaaaaaaaaaaaaaaaaaaaaaaaaaaaaaaaaaaaaaaaaaaaaaaaaaaaaaaaaaaaaaaaaaaaaaaaaaaaaaaaaaaa
aaaaaaaaaaaaaaaaaaaaaaaaaaaaaaaaaaaaaaaaaaaaaaaaaaaaaaaaaaaaaaaaaaaaaaaaaaaaaaaaaaaaaaaaaaaaaaaaaaaaaaaaaaaaaaaaaaaaaaaaaaaaaaaaaaaaaaaaaaaa
aaaaaaaaaaaaaaaaaaaaaaaaaaaaaaaaaaaaaaaaaaaaaaaaaaaaaaaaaaaaaaaaaaaaaaaaaaaaaaaaaaaaaaaaaaaaaaaaaaaaaaaaaaaaaaaaaaaaaaaaaaaaaaaaaaaaaaaaaaaa
aaaaaaaaaaaaaaaaaaaaaaaaaaaaaaaaaaaaaaaaaaaaaaaaaaaaaaaaaaaaaaaaaaaaaaaaaaaaaaaaaaaaaaaaaaaaaaaaaaaaaaaaaaaaaaaaaaaaaaaaaaaaaaaaaaaaaaaaaaaa
aaaaaaaaaaaaaaaaaaaaaaaaaaaaaaaaaaaaaaaaaaaaaaaaaaaaaaaaaaaaaaaaaaaaaaaaaaaaaaaaaaaaaaaaaaaaaaaaaaaaaaaaaaaaaaaaaaaaaaaaaaaaaaaaaaaaaaaaaaaa
aaaaaaaaaaaaaaaaaaaaaaaaaaaaaaaaaaaaaaaaaaaaaaaaaaaaaaaaaaaaaaaaaaaaaaaaaaaaaaaaaaaaaaaaaaaaaaaaaaaaaaaaaaaaaaaaaaaaaaaaaaaaaaaaaaaaaaaaaaaa
aaaaaaaaaaaaaaaaaaaaaaaaaaaaaaaaaaaaaaaaaaaaaaaaaaaaaaaaaaaaaaaaaaaaaaaaaaaaaaaaaaaaaaaaaaaaaaaaaaaaaaaaaaaaaaaaaaaaaaaaaaaaaaaaaaaaaaaaaaaa
aaaaaaaaaaaaaaaaaaaaaaaaaaaaaaaaaaaaaaaaaaaaaaaaaaaaaaaaaaaaaaaaaaaaaaaaaaaaaaaaaaaaaaaaaaaaaaaaaaaaaaaaaaaaaaaaaaaaaaaaaaaaaaaaaaaaaaaaaaaa
aaaaaaaaaaaaaaaaaaaaaaaaaaaaaaaaaaaaaaaaaaaaaaaaaaaaaaaaaaaaaaaaaaaaaaaaaaaaaaaaaaaaaaaaaaaaaaaaaaaaaaaaaaaaaaaaaaaaaaaaaaaaaaaaaaaaaaaaaaaa
aaaaaaaaaaaaaaaaaaaaaaaaaaaaaaaaaaaaaaaaaaaaaaaaaaaaaaaaaaaaaaaaaaaaaaaaaaaaaaaaaaaaaaaaaaaaaaaaaaaaaaaaaaaaaaaaaaaaaaaaaaaaaaaaaaaaaaaaaaaa
aaaaaaaaaaaaaaaaaaaaaaaaaaaaaaaaaaaaaaaaaaaaaaaaaaaaaaaaaaaaaaaaaaaaaaaaaaaaaaaaaaaaaaaaaaaaaaaaaaaaaaaaaaaaaaaaaaaaaaaaaaaaaaaaaaaaaaaaaaaa
aaaaaaaaaaaaaaaaaaaaaaaaaaaaaaaaaaaaaaaaaaaaaaaaaaaaaaaaaaaaaaaaaaaaaaaaaaaaaaaaaaaaaaaaaaaaaaaaaaaaaaaaaaaaaaaaaaaaaaaaaaaaaaaaaaaaaaaaaaaa
aaaaaaaaaaaaaaaaaaaaaaaaaaaaaaaaaaaaaaaaaaaaaaaaaaaaaaaaaaaaaaaaaaaaaaaaaaaaaaaaaaaaaaaaaaaaaaaaaaaaaaaaaaaaaaaaaaaaaaaaaaaaaaaaaaaaaaaaaaaa
aaaaaaaaaaaaaaaaaaaaaaaaaaaaaaaaaaaaaaaaaaaaaaaaaaaaaaaaaaaaaaaaaaaaaaaaaaaaaaaaaaaaaaaaaaaaaaaaaaaaaaaaaaaaaaaaaaaaaaaaaaaaaaaaaaaaaaaaaaaa
aaaaaaaaaaaaaaaaaaaaaaaaaaaaaaaaaaaaaaaaaaaaaaaaaaaaaaaaaaaaaaaaaaaaaaaaaaaaaaaaaaaaaaaaaaaaaaaaaaaaaaaaaaaaaaaaaaaaaaaaaaaaaaaaaaaaaaaaaaaa
aaaaaaaaaaaaaaaaaaaaaaaaaaaaaaaaaaaaaaaaaaaaaaaaaaaaaaaaaaaaaaaaaaaaaaaaaaaaaaaaaaaaaaaaaaaaaaaaaaaaaaaaaaaaaaaaaaaaaaaaaaaaaaaaaaaaaaaaaaaa
aaaaaaaaaaaaaaaaaaaaaaaaaaaaaaaaaaaaaaaaaaaaaaaaaaaaaaaaaaaaaaaaaaaaaaaaaaaaaaaaaaaaaaaaaaaaaaaaaaaaaaaaaaaaaaaaaaaaaaaaaaaaaaaaaaaaaaaaaaaa
aaaaaaaaaaaaaaaaaaaaaaaaaaaaaaaaaaaaaaaaaaaaaaaaaaaaaaaaaaaaaaaaaaaaaaaaaaaaaaaaaaaaaaaaaaaaaaaaaaaaaaaaaaaaaaaaaaaaaaaaaaaaaaaaaaaaaaaaaaaa
aaaaaaaaaaaaaaaaaaaaaaaaaaaaaaaaaaaaaaaaaaaaaaaaaaaaaaaaaaaaaaaaaaaaaaaaaaaaaaaaaaaaaaaaaaaaaaaaaaaaaaaaaaaaaaaaaaaaaaaaaaaaaaaaaaaaaaaaaaaa
aaaaaaaaaaaaaaaaaaaaaaaaaaaaaaaaaaaaaaaaaaaaaaaaaaaaaaaaaaaaaaaaaaaaaaaaaaaaaaaaaaaaaaaaaaaaaaaaaaaaaaaaaaaaaaaaaaaaaaaaaaaaaaaaaaaaaaaaaaaa
aaaaaaaaaaaaaaaaaaaaaaaaaaaaaaaaaaaaaaaaaaaaaaaaaaaaaaaaaaaaaaaaaaaaaaaaaaaaaaaaaaaaaaaaaaaaaaaaaaaaaaaaaaaaaaaaaaaaaaaaaaaaaaaaaaaaaaaaaaaa
ddaaaaaaaaaaaaaaaaaaaaaaaaaaaaaaaaaaaaaaaaaaaaaaaaaaaaaaaaaaaaaaaaaaaaaaaaaaaaaaaaaaaaaaaaaaaaaaaaaaaaaaaaaaaaaaaaaaaaaaaaaaaaaaaaaaaaaaaaaa
ddaaaaaaaaaaaaaaaaaaaaaaaaaaaaaaaaaaaaaaaaaaaaaaaaaaaaaaaaaaaaaaaaaaaaaaaaaaaaaaaaaaaaaaaaaaaaaaaaaaaaaaaaaaaaaaaaaaaaaaaaaaaaaaaaaaaaaaaaaa
ddaaaaaaaaaaaaaaaaaaaaaaaaaaabcbaaaaaaaaaaaaaaaaaaaaaaaaaaaaaaaaaaabcbaaaaaaaaaaaaaaaaaaaaaaaaaaaaaaaaaaabcbaaaaaaaaaaaaaaaaaaaaaaaaaaaaaaaa
ddaaaaaaaaaaaaaaaaaaaaaaaaaaabcbaaaaaaaaaaaaaaaaaaaaaaaaaaaaaaaaaaabcbaaaaaaaaaaaaaaaaaaaaaaaaaaaaaaaaaaabcbaaaaaaaaaaaaaaaaaaaaaaaaaaaaaaaa
ddaaaaaaaaaaaaaaaaaaaaaaaaaaabcbaaaaaaaaaaaaaaaaaaaaaaaaaaaaaaaaaaabcbaaaaaaaaaaaaaaaaaaaaaaaaaaaaaaaaaaabcbaaaaaaaaaaaaaaaaaaaaaaaaaaaaaaaa
ddaaaaaaaaaaaaaaaaaaaaaaaaaaabcbaaaaaaaaaaaaaaaaaaaaaaaaaaaaaaaaaaabcbaaaaaaaaaaaaaaaaaaaaaaaaaaaaaaaaaaabcbaaaaaaaaaaaaaaaaaaaaaaaaaaaaaaaa
ddaaaaaaaaaaaaaaaaaaaaaaaaaaabcbaaaaaaaaaaaaaaaaaaaaaaaaaaaaaaaaaaabcbaaaaaaaaaaaaaaaaaaaaaaaaaaaaaaaaaaabcbaaaaaaaaaaaaaaaaaaaaaaaaaaaaaaaa
ddaaaaaaaaaaaaaaaaaaaaaaaaaaabcbaaaaaaaaaaaaaaaaaaaaaaaaaaaaaaaaaaabcbaaaaaaaaaaaaaaaaaaaaaaaaaaaaaaaaaaabcbaaaaaaaaaaaaaaaaaaaaaaaaaaaaaaaa
ddaaaaaaaaaaaaaaaaaaaaaaaaaaabcbaaaaaaaaaaaaaaaaaaaaaaaaaaaaaaaaaaabcbaaaaaaaaaaaaaaaaaaaaaaaaaaaaaaaaaaabcbaaaaaaaaaaaaaaaaaaaaaaaaaaaaaaaa
ddaaaaaaaaaaaaaaaaaaaaaaaaaaabcbaaaaaaaaaaaaaaaaaaaaaaaaaaaaaaaaaaabcbaaaaaaaaaaaaaaaaaaaaaaaaaaaaaaaaaaabcbaaaaaaaaaaaaaaaaaaaaaaaaaaaaaaaa
ddaaaaaaaaaaaaaaaaaaaaaaaaaaabcbaaaaaaaaaaaaaaaaaaaaaaaaaaaaaaaaaaabcbaaaaaaaaaaaaaaaaaaaaaaaaaaaaaaaaaaabcbaaaaaaaaaaaaaaaaaaaaaaaaaaaaaaaa
ddaaaaaaaaaaaaaaaaaaaaaaaaaaabcbaaaaaaaaaaaaaaaaaaaaaaaaaaaaaaaaaaabcbaaaaaaaaaaaaaaaaaaaaaaaaaaaaaaaaaaabcbaaaaaaaaaaaaaaaaaaaaaaaaaaaaaaaa
ddaaaaaaaaaaaaaaaaaaaaaaaaaaabcbaaaaaaaaaaaaaaaaaaaaaaaaaaaaaaaaaaabcbaaaaaaaaaaaaaaaaaaaaaaaaaaaaaaaaaaabcbaaaaaaaaaaaaaaaaaaaaaaaaaaaaaaaa
ddaaaaaaaaaaaaaaaaaaaaaaaaaaabcbaaaaaaaaaaaaaaaaaaaaaaaaaaaaaaaaaaabcbaaaaaaaaaaaaaaaaaaaaaaaaaaaaaaaaaaabcbaaaaaaaaaaaaaaaaaaaaaaaaaaaaaaaa
ddaaaaaaaaaaaaaaaaaaaaaaaaaabbcbbaaaaaaaaaaaaaaaaaaaaaaaaaaaaaaaaabbcbbaaaaaaaaaaaaaaaaaaaaaaaaaaaaaaaaabbcbbaaaaaaaaaaaaaaaaaaaaaaaaaaaaaaa
ddaaaaaaaaaaaaaaaaaaaaaaaaaaabcbaaaaaaaaaaaaaaaaaaaaaaaaaaaaaaaaaaabcbaaaaaaaaaaaaaaaaaaaaaaaaaaaaaaaaaaabcbaaaaaaaaaaaaaaaaaaaaaaaaaaaaaaaa
ddaaaaaaaaaaaaaaaaaaaaaaaaaaabcbaaaaaaaaaaaaaaaaaaaaaaaaaaaaaaaaaaabcbaaaaaaaaaaaaaaaaaaaaaaaaaaaaaaaaaaabcbaaaaaaaaaaaaaaaaaaaaaaaaaaaaaaaa
ddaaaaaaaaaaaaaaaaaaaaaaaaaaabcbaaaaaaaaaaaaaaaaaaaaaaaaaaaaaaaaaaabcbaaaaaaaaaaaaaaaaaaaaaaaaaaaaaaaaaaabcbaaaaaaaaaaaaaaaaaaaaaaaaaaaaaaaa
ddaaaaaaaaaaaaaaaaaaaaaaaaaaabcbaaaaaaaaaaaaaaaaaaaaaaaaaaaaaaaaaaabcbaaaaaaaaaaaaaaaaaaaaaaaaaaaaaaaaaaabcbaaaaaaaaaaaaaaaaaaaaaaaaaaaaaaaa
ddaaaaaaaaaaaaaaaaaaaaaaaaaaabcbaaaaaaaaaaaaaaaaaaaaaaaaaaaaaaaaaaabcbaaaaaaaaaaaaaaaaaaaaaaaaaaaaaaaaaaabcbaaaaaaaaaaaaaaaaaaaaaaaaaaaaaaaa
ddaaaaaaaaaaaaaaaaaaaaaaaaaaabcbaaaaaaaaaaaaaaaaaaaaaaaaaaaaaaaaaaabcbaaaaaaaaaaaaaaaaaaaaaaaaaaaaaaaaaaabcbaaaaaaaaaaaaaaaaaaaaaaaaaaaaaaaa
ddaadddaaaaaaaaaaaaaaaaaaaaaabcbaaaaaaaaaaaaaaaaaaaaaaaaaaaaaaaaaaabcbaaaaaaaaaaaaaaaaaaaaaaaaaaaaaaaaaaabcbaaaaaaaaaaaaaaaaaaaaaaaaaaaaaaaa
ddaadddaaaaaaaaaaaaaaaaaaaaaabcbaaaaaaaaaaaaaaaaaaaaaaaaaaaaaaaaaaabcbaaaaaaaaaaaaaaaaaaaaaaaaaaaaaaaaaaabcbaaaaaaaaaaaaaaaaaaaaaaaaaaaaaaaa
ddaadddaaaaaaaaaaaaaaaaaaaaaabcbaaaaaaaaaaaaaaaaaaaaaaaaaaaaaaaaaaabcbaaaaaaaaaaaaaaaaaaaaaaaaaaaaaaaaaaabcbaaaaaaaaaaaaaaaaaaaaaaaaaaaaaaaa
ddaadddaaaaaaaaaaaaaaaaaaaaaabcbaaaaaaaaaaaaaaaaaaaaaaaaaaaaaaaaaaabcbaaaaaaaaaaaaaaaaaaaaaaaaaaaaaaaaaaabcbaaaaaaaaaaaaaaaaaaaaaaaaaaaaaaaa
ddaadddaaaaaaaaaaaaaaaaaaaaaabcbaaaaaaaaaaaaaaaaaaaaaaaaaaaaaaaaaaabcbaaaaaaaaaaaaaaaaaaaaaaaaaaaaaaaaaaabcbaaaaaaaaaaaaaaaaaaaaaaaaaaaaaaaa
ddaadddaaaaaaaaaaaaaaaabaaaaabcbaaaaabaaaaaaaaaaaaaaaaaaaaaaabaaaaabcbaaaaabaaaaaaaaaaaaaaaaaaaaaaabaaaaabcbaaaaabaaaaaaaaaaaaaaaaaaaaaaaaaa
ddaadddaaaaaaaaaaaaaaaaabaaaabcbaaaabaaaaaaaaaaaaaaaaaaaaaaaaabaaaabcbaaaabaaaaaaaaaaaaaaaaaaaaaaaaabaaaabcbaaaabaaaaaaaaaaaaaaaaaaaaaaaaaaa
ddaadddaaaaaaaaaaaaaaaaaabaaabcbaaabaaaaaaaaaaaaaaaaaaaaaaaaaaabaaabcbaaabaaaaaaaaaaaaaaaaaaaaaaaaaaabaaabcbaaabaaaaaaaaaaaaaaaaaaaaaaaaaaaa
ddaadddaaaaaaaaaaaaaaaaaaabbbbcbbbbaaaaaaaaaaaaaaaaaaaaaaaaaaaaabbbbcbbbbaaaaaaaaaaaaaaaaaaaaaaaaaaaaabbbbcbbbbaaaaaaaaaaaaaaaaaaaaaaaaaaaaa
ddaadddaaaaaaaaaaaaaaaaaaabcccccccbaaaaaaaaaaaaaaaaaaaaaaaaaaaaabcccccccbaaaaaaaaaaaaaaaaaaaaaaaaaaaaabcccccccbaaaaaaaaaaaaaaaaaaaaaaaaaaaaa
ddaadddaaaabaaaaaaaaaaaaaabcccccccbaaaaaaaaaaaaaabaaaaaaaaaaaaaabcccccccbaaaaaaaaaaaaaabaaaaaaaaaaaaaabcccccccbaaaaaaaaaaaaaabaaaaaaaaaaaaaa
bbbbbbbbbbbbbbbbbbbbbbbbbbbcccccccbbbbbbbbbbbbbbbbbbbbbbbbbbbbbbbcccccccbbbbbbbbbbbbbbbbbbbbbbbbbbbbbbbcccccccbbbbbbbbbbbbbbbbbbbbbbbbbbbbbb
cccccccccccccccccccccccccccccccccccccccccccccccccccccccccccccccccccccccccccccccccccccccccccccccccccccccccccccccccccccccccccccccccccccccccccc
bbbbbbbbbbbbbbbbbbbbbbbbbbbcccccccbbbbbbbbbbbbbbbbbbbbbbbbbbbbbbbcccccccbbbbbbbbbbbbbbbbbbbbbbbbbbbbbbbcccccccbbbbbbbbbbbbbbbbbbbbbbbbbbbbbb
ddaadddaaaabaaaaaaaaaaaaaabcccccccbaaaaaaaaaaaaaabaaaaaaaaaaaaaabcccccccbaaaaaaaaaaaaaabaaaaaaaaaaaaaabcccccccbaaaaaaaaaaaaaabaaaaaaaaaaaaaa
ddaadddaaaaaaaaaaaaaaaaaaabcccccccbaaaaaaaaaaaaaaaaaaaaaaaaaaaaabcccccccbaaaaaaaaaaaaaaaaaaaaaaaaaaaaabcccccccbaaaaaaaaaaaaaaaaaaaaaaaaaaaaa
ddaadddaaaaaaaaaaaaaaaaaaabbbbcbbbbaaaaaaaaaaaaaaaaaaaaaaaaaaaaabbbbcbbbbaaaaaaaaaaaaaaaaaaaaaaaaaaaaabbbbcbbbbaaaaaaaaaaaaaaaaaaaaaaaaaaaaa
ddaadddaaaaaaaaaaaaaaaaaabaaabcbaaabaaaaaaaaaaaaaaaaaaaaaaaaaaabaaabcbaaabaaaaaaaaaaaaaaaaaaaaaaaaaaabaaabcbaaabaaaaaaaaaaaaaaaaaaaaaaaaaaaa
ddaadddaaaaaaaaaaaaaaaaabaaaabcbaaaabaaaaaaaaaaaaaaaaaaaaaaaaabaaaabcbaaaabaaaaaaaaaaaaaaaaaaaaaaaaabaaaabcbaaaabaaaaaaaaaaaaaaaaaaaaaaaaaaa
ddaadddaaaaaaaaaaaaaaaabaaaaabcbaaaaabaaaaaaaaaaaaaaaaaaaaaaabaaaaabcbaaaaabaaaaaaaaaaaaaaaaaaaaaaabaaaaabcbaaaaabaaaaaaaaaaaaaaaaaaaaaaaaaa
dddddddaaaaaaaaaaaaaaaaaaaaaabcbaaaaaaaaaaaaaaaaaaaaaaaaaaaaaaaaaaabcbaaaaaaaaaaaaaaaaaaaaaaaaaaaaaaaaaaabcbaaaaaaaaaaaaaaaaaaaaaaaaaaaaaaaa
dddddddaaaaaaaaaaaaaaaaaaaaaabcbaaaaaaaaaaaaaaaaaaaaaaaaaaaaaaaaaaabcbaaaaaaaaaaaaaaaaaaaaaaaaaaaaaaaaaaabcbaaaaaaaaaaaaaaaaaaaaaaaaaaaaaaaa
dddddddaaaaaaaaaaaaaaaaaaaaaabcbaaaaaaaaaaaaaaaaaaaaaaaaaaaaaaaaaaabcbaaaaaaaaaaaaaaaaaaaaaaaaaaaaaaaaaaabcbaaaaaaaaaaaaaaaaaaaaaaaaaaaaaaaa
ddaadddaaaaaaaaaaaaaaaaaaaaaabcbaaaaaaaaaaaaaaaaaaaaaaaaaaaaaaaaaaabcbaaaaaaaaaaaaaaaaaaaaaaaaaaaaaaaaaaabcbaaaaaaaaaaaaaaaaaaaaaaaaaaaaaaaa
ddaadddaaaaaaaaaaaaaaaaaaaaaabcbaaaaaaaaaaaaaaaaaaaaaaaaaaaaaaaaaaabcbaaaaaaaaaaaaaaaaaaaaaaaaaaaaaaaaaaabcbaaaaaaaaaaaaaaaaaaaaaaaaaaaaaaaa
ddaadddaaaaaaaaaaaaaaaaaaaaaabcbaaaaaaaaaaaaaaaaaaaaaaaaaaaaaaaaaaabcbaaaaaaaaaaaaaaaaaaaaaaaaaaaaaaaaaaabcbaaaaaaaaaaaaaaaaaaaaaaaaaaaaaaaa
ddaadddaaaaaaaaaaaaaaaaaaaaaabcbaaaaaaaaaaaaaaaaaaaaaaaaaaaaaaaaaaabcbaaaaaaaaaaaaaaaaaaaaaaaaaaaaaaaaaaabcbaaaaaaaaaaaaaaaaaaaaaaaaaaaaaaaa
ddaadddaaaaaaaaaaaaaaaaaaaaaabcbaaaaaaaaaaaaaaaaaaaaaaaaaaaaaaaaaaabcbaaaaaaaaaaaaaaaaaaaaaaaaaaaaaaaaaaabcbaaaaaaaaaaaaaaaaaaaaaaaaaaaaaaaa
ddaadddaaaaaaaaaaaaaaaaaaaaaabcbaaaaaaaaaaaaaaaaaaaaaaaaaaaaaaaaaaabcbaaaaaaaaaaaaaaaaaaaaaaaaaaaaaaaaaaabcbaaaaaaaaaaaaaaaaaaaaaaaaaaaaaaaa
ddaadddaaaaaaaaaaaaaaaaaaaaaabcbaaaaaaaaaaaaaaaaaaaaaaaaaaaaaaaaaaabcbaaaaaaaaaaaaaaaaaaaaaaaaaaaaaaaaaaabcbaaaaaaaaaaaaaaaaaaaaaaaaaaaaaaaa
ddaadddaaaaaaaaaaaaaaaaaaaaaabcbaaaaaaaaaaaaaaaaaaaaaaaaaaaaaaaaaaabcbaaaaaaaaaaaaaaaaaaaaaaaaaaaaaaaaaaabcbaaaaaaaaaaaaaaaaaaaaaaaaaaaaaaaa
ddaadddaaaaaaaaaaaaaaaaaaaaabbcbbaaaaaaaaaaaaaaaaaaaaaaaaaaaaaaaaabbcbbaaaaaaaaaaaaaaaaaaaaaaaaaaaaaaaaabbcbbaaaaaaaaaaaaaaaaaaaaaaaaaaaaaaa
ddaadddaaaaaaaaaaaaaaaaaaaaaabcbaaaaaaaaaaaaaaaaaaaaaaaaaaaaaaaaaaabcbaaaaaaaaaaaaaaaaaaaaaaaaaaaaaaaaaaabcbaaaaaaaaaaaaaaaaaaaaaaaaaaaaaaaa
ddaadddaaaaaaaaaaaaaaaaaaaaaabcbaaaaaaaaaaaaaaaaaaaaaaaaaaaaaaaaaaabcbaaaaaaaaaaaaaaaaaaaaaaaaaaaaaaaaaaabcbaaaaaaaaaaaaaaaaaaaaaaaaaaaaaaaa
ddaadddddddddddddddddddddddddbcbdddddddddddddddddddddddddddddddddddbcbdddddddddddddddddddddddddddddddddddbcbddddddddddddddddddddddddddaaaaaa
ddaadddddddddddddddddddddddddbcbdddddddddddddddddddddddddddddddddddbcbdddddddddddddddddddddddddddddddddddbcbddddddddddddddddddddddddddaaaaaa
ddaadddddddddddddddddddddddddbcbdddddddddddddddddddddddddddddddddddbcbdddddddddddddddddddddddddddddddddddbcbddddddddddddddddddddddddddaaaaaa
ddaadddddddddddddddddddddddddbcbdddddddddddddddddddddddddddddddddddbcbdddddddddddddddddddddddddddddddddddbcbddddddddddddddddddddddddddaaaaaa
ddaadddddddddddddddddddddddddbcbdddddddddddddddddddddddddddddddddddbcbdddddddddddddddddddddddddddddddddddbcbddddddddddddddddddddddddddaaaaaa
ddaadddddddddddddddddddddddddbcbdddddddddddddddddddddddddddddddddddbcbdddddddddddddddddddddddddddddddddddbcbddddddddddddddddddddddddddaaaaaa
ddaadddddddddddddddddddddddddbcbdddddddddddddddddddddddddddddddddddbcbdddddddddddddddddddddddddddddddddddbcbddddddddddddddddddddddddddaaaaaa
ddaadddddddddddddddddddddddddbcbdddddddddddddddddddddddddddddddddddbcbdddddddddddddddddddddddddddddddddddbcbddddddddddddddddddddddddddaaaaaa
ddaadddddddddddddddddddddddddbcbdddddddddddddddddddddddddddddddddddbcbdddddddddddddddddddddddddddddddddddbcbddddddddddddddddddddddddddaaaaaa
"}
